########################
########################
######          ########
##      #####     ######
##    ##! ! !##     ####
      ##!_!_!##   ######
                ########
            ############
########################