########################
#####%#%%%%##%%%#%%%%%%#
#%##%%%%##%%%%#%%%####%#
#%##%####%%########%#%%#
#%%%%###%%%%###%%%%%#%##
#%#%#######%###%# ###%##
#%#%%%%%###%%%%%###%%%##
#%####%#####%##%###%####
###################%####