########################
##########      ########
##########        ######
##########              
########            ####
####                ####
                  ######
                  ######
########################