############      ######
######                ##
##                ######
                    ####
##                  ####
####                ####
####              ######
######        ##########
########################