##%#####################
##%###########        ##
##%#########          ##
##%%%%%%%%          ####
##########        ######
########          ######
####                    
####                    
########      ##########