######    ##############
######          ##    ##
######      ##  ##    ##
######      ##  ##    ##
######      ##  ##    ##
######      ##  ##    ##
######      ##  ##  ####
######      ##      ####
#####%##################