########################
## []  []  []  []  [] ##
##_[]__[]__[]__[]__[]_##
##                      
##                      
##_  __  __  __  __  _  
## []  []  []  []  [] ##
## []  []  []  []  [] ##
########################