#################%######
## !~~^~~~~~~~!  -    ##
##!~><>~~~^~~~~! -    ##
##!~~~~~~~<><~~! -      
## !~~^~~^~~~~!  -------
##               -      
##    ------------    ##
## _  - ___{}___ -  _ ##
##[   - !~~[]~~! -   ]##
##[   - !~~~~~~! -   ]##
##[_  - !======! -  _]##
########################