######%#################
## --                 ##
## //              ///- 
## //      _       // ##
## //     +++      // ##
## //    .$$$.     // ##
## //    !===!     // ##
## ////- !===! -///// ##
## //  _________   // ##
## // _!0000000!_  // ##
## //{_!X00$00X!_] // ##
## // _!0000000!_  // ##
## //[_!X00$00X!_} // ##
## // _!0000000!_  // ##
## //{_!X00$00X!_] // ##
## // _!0000000!_  // ##
## //[_!X00$00X!_} // ##
## // _!0000000!_  // ##
## //{_!X00$00X!_] // ##
## //  !=======!   // ##
## ////////////////// ##
##()      ><>       ()##
########################

