################################################
##~~~~~^~~~~~~~~~~~<><~~~~~^~~><>~~~~~~~~~~~~~##
##~~~~><>~~~~~~~~^~~~~~~~~~~~~~~~~~~~~~~~~~^~~##
##~^~~~~~^~~~~~ ~~~~<><~~~~~~~~^~~~~~><>~~~~~^##
##~~~~~~~<><~~^~~~~~~~^~~~~~><>~~~~^~~~~~~~~~~##
##~~^~~~~~~~~~~~><>~~~~~~~~~~~~~~~~~~~~~~^~~~~##
##^~<><~~~~~^~~~~~~~~~~~~~~~~~~^~~~~~~~~<><~^~##
####################################~~~#########