########################
###########    #########
###### ^    ^     ######
####     ''        #####
###   (______)          
##                 #####
##           ###########
##     #################
##%#####################