########################
##                    ##
 -///////////////     ##
##             //     ##
##         _________  ##
##       _!=========! ##
##      !_+~~~~~~~~~! ##
##()      !=========! ##
#################%######