####################################~~~#########
##~^~~~~~~~~~~<><~~~~~~^~~~~><>~^~~~~~~~~~^~~~##
##~~~><>~~~~^~~~~~~~~~~~~~^~~~~~~~~~^~~~~~<><~##
                       - ~~~~<><~~~~~~~~~~~^~~##
------------------------    ~~~^~~~<><~~^~~~~~##
          -            -      ~~~^~~~~^~~><>~~##
##        -            ---------------------  ##
##########/#####################################
## _  __     ##
##{_ !00!    ##
##{_ !00!  ()##
###############