########################
##                    ##
##                    ##
##                    ##
##                    ##
##                    ##
##                    ##
##                    ##
########################